
NO       ./resources/walls_2/north.xpm
SO            ./resources/walls_2/south.xpm
WE         ./resources/walls_2/west.xpm
EA                            ./resources/walls_2/east.xpm

F         96, 169, 23
C          135, 206, 235

        1111111111111111111111111
        1000000000110000000000001
        10110000011000000000W0001
        1001000000000000000000001
111111111011000000010000000000001
100000000011000000110111111111111
11110111111111011100000000001
111101111111110111010100100010
110000001101010111000000100010
100000000000000011000000100010
100000000000000011010100100010
1100000111010101111101111000111
11110111 1110101 1011110100010
11111111 1111111 111111111111000